0
xxxxxxxxxxxxxxxxxxxxxxxxxxxxxxxxxxxxx
x                                   x
x                           xx      x
x                           xx      x                             
x                           xx      x
x                           xx      x
x                           xx      x
x                  xxx         xx      x
x                           xx      x
x                           xx      x
x                           xx      x
x                           xx      x
x                           xx      x
x                           xx
xS                          xx      x
xxxxxxxxxxxxxxxxxxxxxxxxxxxxxxxxxxxxx
