0
xxxxxxxxxxxxxxxxxxxxxxxxxxxxxxxxxxx
x                                 x
x                                 x
x  xxxxxxxxxxxxxxxxxxxxxxxxxxxx   x
x  x                          x   x
x  x                          x   x
x  x   xxxxxxxxxxxxxxxxxxxx   x   x
x  x   x                  x   x   x
x  x   x  xxxxxxxxxxxxxxxxx   x   x
x  x   x                      x   x
x  x   x                      x   x
x  x   xxxxxxxxxxxxxxxxxxxxxxxx   x
x  x                               
x  x                              x
x  xxxxxxxxxxxxxxxxxxxxxxxxxxxxxxxx
x                                 x
x                                Sx
xxxxxxxxxxxxxxxxxxxxxxxxxxxxxxxxxxx
