0
xxxxxxxxxxxxxxxxxxxxxxxxxxxxxxxxxxxx
x      xx      xx      xx      xx  x
x  xx  xx  xx  xx  xx  xx  xx  xx  x
x  xx  xx  xx  xx  xx  xx  xx  xx  x
x  xx  xx  xx  xx  xx  xx  xx  xx  x
x  xx  xx  xx  xx  xx  xx  xx  xx  x
x  xx  xx  xx  xx  xx  xx  xx  xx  x
x  xx  xx  xx  xx  xx  xx  xx  xx  x
x  xx  xx  xx  xx  xx  xx  xx  xx  x
x  xx  xx  xx  xx  xx  xx  xx  xx  x
x  xx  xx  xx  xx  xx  xx  xx  xx  x
x  xx  xx  xx  xx  xx  xx  xx  xx  x
x  xx  xx  xx  xx  xx  xx  xx  xx   
x  xx  xx  xx  xx  xx  xx  xx  xx  x
x  xx  xx  xx  xx  xx  xx  xx  xx  x
x  xx  xx  xx  xx  xx  xx  xx  xx  x
xS          xx      xx             x
xxxxxxxxxxxxxxxxxxxxxxxxxxxxxxxxxxxx
