0
xxxxxxxxxxxxxxxxxxxxxxxxxxxxxxxxxxxxx
x      xx      xx      xx       xx  x
x  xx  xx  xx  xx  xx  xx  x x  xx  x
x  x      xx           xx            
x  xx  xx  xxxxxx  xx  xx  xx       x
x  xx  xx  xx  xx  xx  xx   xx  xx  x
x  xx  xx  xx  xx  xx  xx   xxxxxxxxx
x  xx xx  xx  xx  x    xx           x
x  xx  xxxxxxxxxxx  xx  xx  xx  xx  x
x   xx  xx  xx  xx  xx  xx  xx  x   x
x  xxxxxxxxxxxxxxx   xxxxxxxxx  xx  x
x  xxxxxxxxxxxxxxxxx  xx  xx  x     x
x  xx  xx  xx  xx  xx  xx  xx  xx   x
x   xx         xx  x   xx           x
x  xxxxxxxxxx  xx  xx  xx  xx  xxx  x
x  xx  xx  xx  xx  xx  xx  xx  xxx  x
xS xx      xx      xx xx    xx  x   x
xxxxxxxxxxxxxxxxxxxxxxxxxxxxxxxxxxxxx
